{ 
Weapon Short_Sword 0 2 10
Consumable Small_Health_Potion 857 90 30
Monster Monster_One 300 600 2 100 
}

0 0 0
1 1 1 1 1 1 1 1 1 1 1 1 1 1 1 1 1 1 1 1 1 1
1 W W W W W W W W W W W W W W W W W W 1 1 1
1 W 1 1 1 W 1 W 1 W 1 W 1 1 1 W 1 1 W 1 1 1
1 W 1 W 1 W 1 W 1 W 1 W 1 1 1 W 1 1 W 1 1 1
1 W 1 W 1 N 1 N 1 N 1 W W 1 1 W 1 1 W W N 1
1 W 1 W 1 1 1 1 1 1 1 1 W 1 1 W 1 1 1 1 1 1
1 W 1 W 1 1 1 1 1 1 1 1 W W W W 1 1 1 1 1 1
1 W 1 W 1 1 1 1 1 1 1 1 1 1 1 1 1 1 1 1 1 1
1 W 1 W W W W W W W W W W W 1 W W W 1 1 1 1
1 W 1 W 1 1 1 1 W 1 1 1 1 W 1 W 1 1 1 1 1 1
1 W 1 W 1 1 1 1 W 1 1 W W W W W 1 1 1 1 1 1
1 W 1 W 1 1 1 1 W 1 1 W 1 W 1 W 1 1 1 1 1 1
1 W 1 W 1 1 1 1 W 1 1 W 1 W 1 W 1 1 1 1 1 1
1 W 1 W 1 1 1 1 W 1 1 W 1 W 1 W 1 1 1 1 1 1
1 W 1 W 1 1 1 1 W 1 1 W W W W W 1 W 1 1 1 1
1 W 1 W 1 1 1 1 W 1 1 1 1 1 1 1 1 W 1 1 1 1
1 W W W 1 1 1 1 W 1 W W W W W 1 1 W 1 1 1 1
1 W 1 W 1 1 1 1 W 1 W 1 1 1 W 1 1 W 1 1 1 1
1 W 1 W 1 1 1 1 W 1 W W W W W W W W W W W 1
1 W 1 W 1 1 1 1 W 1 W 1 W 1 1 1 1 1 1 1 W 1
1 W W W 1 1 1 1 W W W 1 W W W W W W W 1 N 1
1 1 1 1 1 1 1 1 1 1 1 1 1 1 1 1 1 1 1 1 1 1
