{ 
Weapon Short_Sword 0 2 10
Consumable Small_Health_Potion 857 90 30
Monster Monster_One 300 600 2 1 10 10
Monster Monster_Two 400 700 3 1 10 10
Monster Monster_Three 500 700 4 1 10 10
Monster Monster_Four 600 700 1 1 10 10
}

0 0 0
1 1 1 1 1 1 1 1 1 1 1 1 1 1 1 1 1 1 1 1 1 1
1 W W W W 1 W W W 1 W W W 1 W W W W 1 W W 1
1 W W W W 1 W W W 1 W W W 1 W W W W 1 W W 1
1 W W 1 W W W 1 W W W 1 W W W 1 1 W 1 W W 1
1 W W 1 W W W 1 W W W 1 W W W 1 1 W 1 W W 1
1 1 1 1 1 1 1 1 1 1 1 1 1 1 W 1 1 W 1 W W 1
1 W W W W W W W W W W W W W W 1 1 W 1 W W 1
1 W W W W W W W W W W W W W W W W W 1 W W 1
1 W W W W W W 1 1 1 1 1 W W 1 1 1 1 1 W W 1
1 W W W W W 1 1 1 1 1 1 W W 1 1 1 1 1 W W 1
1 W W W W 1 1 1 1 1 1 1 W W W W W W W W W 1
1 W W W 1 1 1 1 1 1 1 1 W W W W W W W W W 1
1 W W 1 1 1 1 1 1 1 1 1 W W 1 1 W W 1 1 W 1
1 W W 1 W W W W W W W W W W 1 1 W W 1 1 W 1
1 W W 1 W W W W W W W W W W 1 1 W W 1 1 W 1
1 W W 1 W W 1 1 1 1 1 W W W 1 1 1 1 1 1 W 1
1 W W 1 W W 1 1 1 1 1 W W W 1 1 1 1 1 1 W 1
1 W W 1 W W 1 1 M 1 1 W W W 1 1 W W 1 1 W 1
1 W W 1 W W 1 1 W 1 1 W W W 1 1 W W 1 1 W 1
1 W W 1 W W W W W W W W W W 1 1 W W 1 1 W 1
1 W W 1 W W W W W W W W W W W W W W W W W 1
1 1 1 1 1 1 1 1 1 1 1 1 1 1 1 1 1 1 1 1 1 1
